restaurant_ids,name,cuisine,negative_count,neutral_count,positive_count,total,positive_percentage,negative_percentage,neutral_percentage
1,Domino's Pizza Flinders St,Fast Food,2,2,10,14,71,14,14
2,City Kebabs,Fast Food,7,2,7,16,44,44,12
3,Royale PizzaMelbourne,Pizza,10,1,15,26,58,38,4
4,Cherry and Twigs,Café,2,1,20,23,87,9,4
5,Restaurant 1903,Modern Australian,1,3,22,26,85,4,12
6,Tokyo Maki - Melbourne,Japanese,2,0,21,23,91,9,0
7,The Hardware Société,Café,1,0,18,19,95,5,0
8,Delhi Streets,Indian,2,0,20,22,91,9,0
9,Gaylord Indian Restaurant,Indian,3,0,22,25,88,12,0
10,Nando's Northbank,Fast Food,0,1,19,20,95,0,5
11,Sirocco Restaurant & Bar,Modern Australian,2,2,6,10,60,20,20
12,CBD Kebabs,Kebabs,6,2,13,21,62,29,10
13,State of Grace,Bar,3,2,21,26,81,12,8
14,Mr Huang Jin,Taiwan,4,1,13,18,72,22,6
15,Mykonos,Kebabs,8,2,16,26,62,31,8
16,Food Hall,Asian,3,0,21,24,88,12,0
17,K-Rib by Kass Kass,Korean,0,1,23,24,96,0,4
18,Viva Kebabs and grill,Kebabs,12,3,8,23,35,52,13
19,Flinders kebab,Kebabs,0,1,24,25,96,0,4
20,Rockpool Bar & Grill,Modern Australian,4,1,15,20,75,20,5
21,Nobu,Japanese,6,1,16,23,70,26,4
22,Bistro Guillaume,French,6,0,17,23,74,26,0
23,Conservatory,Buffet,7,2,13,22,59,32,9
24,Koko,Japanese,2,3,19,24,79,8,12
25,Spice Temple,Chinese,9,2,15,26,58,35,8
26,Rosetta Ristorante,Italian,7,0,13,20,65,35,0
27,Silks,Chinese,4,0,20,24,83,17,0
28,Petanque Social,Bar,14,3,9,26,35,54,12
29,Ging Thai,Thai,4,1,19,24,79,17,4
30,The Meat & Wine Co Southbank,Steakhouse,2,0,23,25,92,8,0
31,The Waiting Room,Bar,3,0,21,24,88,12,0
32,Left Bank Melbourne Restaurant & Cocktail Bar,Bar,0,1,24,25,96,0,4
33,Subway,Fast Food,14,3,8,25,32,56,12
34,Criniti's Southbank,Italian,5,3,18,26,69,19,12
35,The Breslin Bar & Grill,Steakhouse,3,2,17,22,77,14,9
36,Soho Restaurant and Bar,Italian,1,1,17,19,89,5,5
37,Sushi n Poke,Japanese,12,0,11,23,48,52,0
38,VPR Asian Street Food,Vietnamese,0,1,19,20,95,0,5
39,Five Guys,Fast Food,1,1,17,19,89,5,5
40,Hopscotch Melbourne,Bar,2,2,19,23,83,9,9
41,Ludlow Bar & Dining Room,Bar,4,5,14,23,61,17,22
42,Belgian Beer Café,Bar,1,0,17,18,94,6,0
43,Old Man Pho Southbank - Vietnamese Restaurant,Vietnamese,2,1,13,16,81,12,6
44,Infinite Wasabi,Japanese,1,0,22,23,96,4,0
45,Thailander Riverside Quay,Thai,3,2,12,17,71,18,12
46,Yarra Botanica,Bar,4,1,15,20,75,20,5
47,Melba Restaurant,Buffet,3,0,19,22,86,14,0
48,Ponyfish Island,Bar,3,1,19,23,83,13,4
49,Eureka 89 Dining & Events - Fine Dining Restaurant Melbourne,Fine Dining,0,1,27,28,96,0,4
50,Aria Bar & Lounge,Café,8,0,20,28,71,29,0
51,Spirit Of Melbourne Cruising Restaurant,Modern Australian,1,1,18,20,90,5,5
52,DOC Pizza & Mozzarella Bar - Southbank,Pizza,6,3,12,21,57,29,14
53,Dagwood Deli,Café,1,0,14,15,93,7,0
54,Asado,Argentinian,3,0,21,24,88,12,0
55,La Camera Southgate,Italian,3,0,17,20,85,15,0
56,BearBrass,Bar,2,0,20,22,91,9,0
57,PJ O'Brien's Irish Pub,Bar,2,4,12,18,67,11,22
58,Red Emperor (Southgate) Chinese Restaurant,Chinese,9,1,14,24,58,38,4
59,Tutto Bene,Italian,15,2,11,28,39,54,7
60,Miyako Japanese Cuisine & Teppanyaki,Japanese,1,1,18,20,90,5,5
61,The Deck Southbank,Modern Australian,1,2,16,19,84,5,11
62,Roll'd Southgate,Vietnamese,14,5,8,27,30,52,19
63,Bluetrain,Modern Australian,2,3,19,24,79,8,12
64,Waterfront Southgate,Modern Australian,1,0,20,21,95,5,0
65,Saké Restaurant & Bar,Japanese,5,1,20,26,77,19,4
66,Grill'd Southgate,Burgers,8,0,14,22,64,36,0
67,Teatro Restaurant,Italian,7,0,18,25,72,28,0
68,Stockroom567,Modern Australian,3,0,18,21,86,14,0
69,Miss Siam Thai Cuisine,Thai,3,3,16,22,73,14,14
70,Grill'd Southern Cross,Burgers,9,2,11,22,50,41,9
71,Sushi Izu (inside Woolworths),Japanese,1,2,7,10,70,10,20
72,Vue de monde,Fine Dining,1,1,22,24,92,4,4
73,Rare Steakhouse Downtown,Steakhouse,1,1,19,21,90,5,5
74,Alluvial Restaurant,Modern Australian,2,1,14,17,82,12,6
75,Queens Kebab,Kebabs,3,1,18,22,82,14,5
76,Salted Egg,Chinese,0,0,19,19,100,0,0
77,KoBab,Korean,0,3,17,20,85,0,15
78,Greta,Italian,2,1,15,18,83,11,6
79,Ronnie's,Burgers,11,0,12,23,52,48,0
80,Warabi,Japanese,6,0,15,21,71,29,0
81,Lollo,Modern Australian,3,3,14,20,70,15,15
82,Simpsons Burgers,Burgers,3,1,19,23,83,13,4
83,Sushi Lian,Japanese,6,2,19,27,70,22,7
84,Yarra Falls,Modern Australian,0,1,25,26,96,0,4
85,Maha Restaurant,Middle Eastern,1,2,21,24,88,4,8
86,Bond Street Kitchen,Modern Australian,1,1,16,18,89,6,6
87,Pure South Kitchen,Modern Australian,10,2,11,23,48,43,9
88,Arbory Bar & Eatery,Modern Australian,3,1,16,20,80,15,5
89,Hophaus Bar,Bar,8,0,15,23,65,35,0
90,Clocks at Flinders,Bar,1,3,17,21,81,5,14
91,Riverland Bar,Bar,0,2,26,28,93,0,7
92,Taxi Kitchen,Modern Australian,2,0,19,21,90,10,0
93,Pilgrim Bar,Modern Australian,3,0,27,30,90,10,0
94,Victoria by Farmer's Daughters,Modern Australian,4,0,22,26,85,15,0
95,Mama's Canteen,Middle Eastern,2,0,19,21,90,10,0
96,The Bottom End,Bar,3,0,19,22,86,14,0
97,Spicy Korea,Korean,1,1,18,20,90,5,5
98,Saint & Rogue,Bar,0,1,19,20,95,0,5
99,Brim CC,Japanese,0,2,19,21,90,0,10
100,Rice at Collins 595,Asian,1,2,18,21,86,5,10
101,Palm Sugar Thai Cafe,Thai,2,1,20,23,87,9,4
102,Pokéd,Hawaiian,5,2,13,20,65,25,10
103,SpudBAR,Salads,5,1,10,16,62,31,6
104,KFC Southern Cross Station,Fast Food,7,2,7,16,44,44,12
105,Kartel Catering Melbourne,Café,1,0,17,18,94,6,0
106,O-Bento,Japanese,6,1,11,18,61,33,6
107,Burger Boys,Burgers,3,0,18,21,86,14,0
108,Saving Grace,Bar,3,0,22,25,88,12,0
109,Pho Nom Collins St,Vietnamese,8,0,10,18,56,44,0
110,Henry and The Fox,Modern Australian,2,1,17,20,85,10,5
111,Royal Stacks,Burgers,3,2,16,21,76,14,10
112,Cafenatics,Café,1,0,14,15,93,7,0
113,Rustica Rialto Towers.,Café,2,3,18,23,78,9,13
114,Freyja,Café,8,1,15,24,62,33,4
115,The Sherlock Holmes,Bar,1,1,21,23,91,4,4
116,Bluebag Fresh,Salads,5,0,16,21,76,24,0
117,Dr. Watson's Bar,Bar,2,2,14,18,78,11,11
118,iArepa Market St (South American Street Food),South American,1,0,18,19,95,5,0
119,BIG AUSSIE BURGER &PIZZA,Burgers,1,1,21,23,91,4,4
120,Akaiito Restaurant,Japanese,6,1,17,24,71,25,4
121,Ot?to,Japanese,4,0,18,22,82,18,0
122,Tian38,Chinese,3,1,23,27,85,11,4
123,Nando's 27 Elizabeth St,Fast Food,12,4,4,20,20,60,20
124,Rocket Burgers & Fries,Burgers,5,5,11,21,52,24,24
125,Mensosai Mugen,Japanese,1,2,16,19,84,5,11
126,Platform 270,Modern Australian,2,1,19,22,86,9,5
127,North East China Family,Chinese,4,2,13,19,68,21,11
128,KFC Elizabeth Street Melbourne,Fast Food,2,5,7,14,50,14,36
129,Subway,Fast Food,25,0,2,27,7,93,0
130,Old Durbar Flinders,Nepalese,4,1,19,24,79,17,4
131,PHO Flinders Express,Vietnamese,7,4,15,26,58,27,15
132,McDonald's,Fast Food,11,3,5,19,26,58,16
133,Metro Burgers,Burgers,1,1,23,25,92,4,4
134,Grill'd Degraves Street,Burgers,6,3,11,20,55,30,15
135,Shujinko Flinders,Japanese,3,2,18,23,78,13,9
136,DESI ADDA,Indian,3,0,22,25,88,12,0
137,Young and Jacksons,Modern Australian,3,0,14,17,82,18,0
138,Flora Indian Restaurant,Indian,6,5,13,24,54,25,21
139,Tower Sushi,Japanese,13,3,10,26,38,50,12
140,Lord Of The Fries,Fast Food,12,1,9,22,41,55,5
141,Chocolate Buddha,Japanese,2,1,13,16,81,12,6
142,Time Out Fed Square,Modern Australian,2,1,12,15,80,13,7
143,Hero at ACMI,Café,6,0,15,21,71,29,0
144,Mabu Mabu,Modern Australian,5,2,13,20,65,25,10
145,Beer DeLuxe Fed Square,Modern Australian,3,3,15,21,71,14,14
146,Saravanaa Bhavan,Indian,2,2,14,18,78,11,11
147,Don Don Francis St (Southern Cross),Japanese,1,1,18,20,90,5,5
148,Cinnamon's Sri Lankan Cuisine,Sri Lankan,2,0,20,22,91,9,0
149,Göz City,Turkish,2,1,14,17,82,12,6
150,Pok Pok Junior,Thai,5,1,14,20,70,25,5
151,Simply Spanish,Spanish,5,1,17,23,74,22,4
152,Spice Kitchen Collins,Indian,2,1,18,21,86,10,5
153,Ratee Thai,Thai,2,1,22,25,88,8,4
154,Collins Juice,Persian,0,0,26,26,100,0,0
155,The Mitre Tavern,Bar,1,1,11,13,85,8,8
156,Taco Bill - Collins St,Mexican,2,0,22,24,92,8,0
157,Massi,Italian,2,0,14,16,88,12,0
158,Curry Vault Indian Restaurant and Bar Melbourne,Indian,2,1,24,27,89,7,4
159,Little Brother,Café,5,3,18,26,69,19,12
160,The Irish Times Pub,Irish,0,0,15,15,100,0,0
161,Collins Coffee House,Café,1,2,19,22,86,5,9
162,Strozzi,Italian,1,0,21,22,95,5,0
163,Cha Ching,Chinese,3,0,25,28,89,11,0
164,Seedling Cafe,Café,6,0,16,22,73,27,0
165,ShanDong MaMa Mini,Chinese,3,0,22,25,88,12,0
166,Roule Galette,French,0,2,22,24,92,0,8
167,The Soup Place,Soup,2,2,16,20,80,10,10
168,Cafe Andiamo,Italian,10,1,17,28,61,36,4
169,Tasty Pizza & Kebab,Italian,13,2,1,16,6,81,12
170,Maccaroni Trattoria Italiana,Italian,4,0,18,22,82,18,0
171,MoVida,Spanish,1,2,19,22,86,5,9
172,MoVida Next Door,Spanish,1,1,18,20,90,5,5
173,Subway,Fast Food,13,4,6,23,26,57,17
174,The Duke of Wellington,British,4,0,17,21,81,19,0
175,Kisumé,Japanese,8,3,17,28,61,29,11
176,New York Minute (Flinders St),American,4,2,17,23,74,17,9
177,Desi Dhaba,Indian,6,0,14,20,70,30,0
178,Lucy Liu Kitchen and Bar,Asian Fusion,8,0,14,22,64,36,0
179,Bowery To Williamsburg,American,2,2,17,21,81,10,10
180,La Di Da,Italian,2,2,21,25,84,8,8
181,Hwaro Korean BBQ Restaurant,Korean,1,3,14,18,78,6,17
182,Bar Humbug,Bar,1,2,10,13,77,8,15
183,Scugnizzo Ristorante,Italian,0,1,24,25,96,0,4
184,Woodo Korean Barbecue,Korean,1,0,17,18,94,6,0
185,Delhi Rocks,Indian,1,1,15,17,88,6,6
186,Dosa Hut - Indian Multi Cuisine Restaurant Melbourne CBD,Indian,6,0,10,16,62,38,0
187,Nando's Bourke Place,Fast Food,11,3,6,20,30,55,15
188,Kedai Satay in King St,Indonesian,1,2,14,17,82,6,12
189,Subway,Fast Food,11,0,11,22,50,50,0
190,SHANGHAI SHIFU DUMPLING,Chinese,7,1,16,24,67,29,4
191,Chai 'N' Chilli - Indian Restaurant in Docklands,Indian,0,1,24,25,96,0,4
192,Rock the Wok - Goldsbrough Village,Chinese,9,2,14,25,56,36,8
193,Slate Restaurant Bar,Bar,1,1,15,17,88,6,6
194,Chilangos Mexican Cantina,Mexican,8,0,13,21,62,38,0
195,Roll'd CBW Goldsborough Lane,Vietnamese,16,2,5,23,22,70,9
196,MoVida Aqui,Spanish,5,1,13,19,68,26,5
197,Red Spice Road,Asian Fusion,0,0,24,24,100,0,0
198,Lanai Restaurant & Bar,Modern Australian,3,3,8,14,57,21,21
199,Turf Sports Bar Melbourne,Bar,1,2,23,26,88,4,8
200,SUSHI & NORI,Japanese,4,0,16,20,80,20,0
201,Aki Sushi,Japanese,4,2,15,21,71,19,10
202,Oriental Teahouse Lt Collins,Chinese,3,1,16,20,80,15,5
203,Little Ramen Bar,Japanese,2,1,19,22,86,9,5
204,11 Inch Pizza,Italian,1,0,19,20,95,5,0
205,Trattoria Emilia,Italian,1,0,17,18,94,6,0
206,Hopetoun Tea Rooms est. 1892 (TM),Café,9,3,17,29,59,31,10
207,Guhng The Palace,Korean,2,1,21,24,88,8,4
208,Oh! Banh Mi,Vietnamese,7,1,12,20,60,35,5
209,BROWN BAGELS,Café,1,0,21,22,95,5,0
210,Makan,Indonesian,1,1,17,19,89,5,5
211,Vespa Rossa,Italian,0,1,27,28,96,0,4
212,1932 Cafe & Restaurant,Café,2,1,18,21,86,10,5
213,Box Seafood Restaurant,Seafood,3,2,15,20,75,15,10
214,Om Vegetarian,Vegetarian,1,1,15,17,88,6,6
215,Japanese Teppanyaki Inn,Japanese,2,1,20,23,87,9,4
216,Supernormal,Asian Fusion,0,1,16,17,94,0,6
217,Coda Melbourne,Asian Fusion,2,0,22,24,92,8,0
218,The Meatball & Wine Bar - Flinders Lane,Italian,1,0,25,26,96,4,0
219,Collins Kitchen,Buffet,6,2,13,21,62,29,10
220,Chin Chin,Asian Fusion,6,0,14,20,70,30,0
221,The French Brasserie,French,3,0,25,28,89,11,0
222,Tonka,Indian,4,2,17,23,74,17,9
223,Trinket Bar Melbourne,Bar,2,0,24,26,92,8,0
224,Il Solito Posto,Italian,0,2,24,26,92,0,8
225,Lee Ho Fook,Chinese,2,2,22,26,85,8,8
226,Eau De Vie Melbourne,Bar,0,2,19,21,90,0,10
227,The Fair Trader,Bar,2,1,17,20,85,10,5
228,Grill'd Flinders Lane,Burgers,6,0,16,22,73,27,0
229,Bullrun café,Café,0,1,21,22,95,0,5
230,Swiss Club of Victoria,Swiss,2,3,15,20,75,10,15
231,Pastuso,Peruvian,1,2,22,25,88,4,8
232,A Hereford Beefstouw,Steakhouse,1,2,21,24,88,4,8
233,Cecconi's Flinders Lane Restaurant & Cellar Bar,Italian,6,0,15,21,71,29,0
234,ELCHI,Indian,5,2,14,21,67,24,10
235,Robata Melbourne,Japanese,2,0,24,26,92,8,0
236,Cumulus Inc.,Modern Australian,0,1,18,19,95,0,5
237,SUD Food and Wine,Italian,1,0,22,23,96,4,0
238,Rosa's Canteen,Italian,1,1,15,17,88,6,6
239,ALIBI - Urban Gastropub,Bar,2,1,14,17,82,12,6
240,Subway,Fast Food,1,2,17,20,85,5,10
241,Denmark House,Danish,0,4,14,18,78,0,22
242,Bourke Street Green,Bar,0,0,17,17,100,0,0
243,Villas Restaurant & Bar,Indian,1,0,24,25,96,4,0
244,Rice Paper Scissors,Asian Fusion,2,0,23,25,92,8,0
245,Campari House,Italian,4,2,13,19,68,21,11
246,Subway,Fast Food,11,0,9,20,45,55,0
247,Cafe Segovia,Café,4,3,17,24,71,17,12
248,Manchester Press,Café,1,0,23,24,96,4,0
249,Gourmet Curry Hut Indian Cuisine,Indian,0,0,27,27,100,0,0
250,Corner & Bench,Café,3,0,21,24,88,12,0
251,Ca De Vin,Italian,3,0,12,15,80,20,0
252,Caffé E Torta,Café,3,2,21,26,81,12,8
253,Little Collins Melbourne,Café,6,0,21,27,78,22,0
254,Gopals,Vegetarian,2,1,18,21,86,10,5
255,Cabinet Bar & Balcony,Bar,0,1,15,16,94,0,6
256,Crossways Vegetarian and Vegan Restaurant,Vegetarian,1,0,15,16,94,6,0
257,Sushi Boto,Japanese,2,3,14,19,74,11,16
258,The George on Collins,Modern Australian,1,1,22,24,92,4,4
259,Bistrot d'Orsay,French,2,1,17,20,85,10,5
260,Meatmaiden,Steakhouse,3,1,17,21,81,14,5
261,Il Bacaro,Italian,4,1,22,27,81,15,4
262,Chapter House Coffee,Café,2,2,22,26,85,8,8
263,NOMAD Melbourne,Middle Eastern,1,0,22,23,96,4,0
264,Philippe,French,1,1,23,25,92,4,4
265,Kenzan Japanese Restaurant,Japanese,2,0,11,13,85,15,0
266,Fonda Mexican Flinders Lane,Mexican,7,3,11,21,52,33,14
267,O-Bento,Japanese,11,1,13,25,52,44,4
268,EARL Canteen - Collins Place,Café,3,0,18,21,86,14,0
269,Guzman y Gomez - Collins Place,Mexican,10,2,8,20,40,50,10
270,Di Stasio Citta,Italian,3,0,18,21,86,14,0
271,Botswana Butchery Melbourne,Steakhouse,13,0,13,26,50,50,0
272,Pope Joan,Modern Australian,5,1,14,20,70,25,5
273,Schnitz Collins Place,Fast Food,5,3,12,20,60,25,15
274,Dosirock,Korean,8,4,12,24,50,33,17
275,Gami Chicken & Beer,Korean,2,1,17,20,85,10,5
276,Squires Loft City Grill Room,Steakhouse,3,4,10,17,59,18,24
277,The Workers' Food Room,Café,1,1,21,23,91,4,4
278,Gangnam Pocha,Korean,2,0,24,26,92,8,0
279,Yoon’s Kitchen Lonsdale,Korean,10,1,15,26,58,38,4
280,House Of Kebabs,Kebabs,1,0,28,29,97,3,0
281,Taketori fusion japanese food,Japanese,4,0,22,26,85,15,0
282,ChunChun pocha ????,Korean,1,1,25,27,93,4,4
283,Sao Bar & B.B.Q,Bar,5,1,17,23,74,22,4
284,Oh dumplings,Chinese,4,0,17,21,81,19,0
285,Caterina's Cucina E Bar,Italian,2,1,17,20,85,10,5
286,Korchi City,Korean,5,3,12,20,60,25,15
287,Luci,Modern Australian,3,0,17,20,85,15,0
288,Sool Tong,Korean,1,1,20,22,91,5,5
289,215 Queen's Restaurant and Bar Melbourne,Modern Australian,11,0,14,25,56,44,0
290,Gasthaus on Queen,German,3,0,21,24,88,12,0
291,The Mill Restaurant - Melbourne CBD Restaurant & Bar,Modern Australian,6,1,16,23,70,26,4
292,Grill Steak Seafood,Seafood,3,3,16,22,73,14,14
293,Rare Steakhouse Midtown,Steakhouse,4,1,18,23,78,17,4
294,Triim,Italian,6,2,17,25,68,24,8
295,NAMSAN Korean Restaurant,Korean,5,0,13,18,72,28,0
296,Miznon,Israeli,3,1,18,22,82,14,5
297,French Saloon Private Events,French,1,0,12,13,92,8,0
298,Brother Baba Budan,Café,0,1,22,23,96,0,4
299,Club Retro,Bar,15,1,8,24,33,62,4
300,Shanghai Street,Chinese,4,3,17,24,71,17,12
301,Federal Coffee,Café,6,1,17,24,71,25,4
302,Grab a yabby,Seafood,6,1,12,19,63,32,5
303,Pink. The Restaurant,Modern Australian,15,1,10,26,38,58,4
304,Rozzis,Italian,5,1,13,19,68,26,5
305,ARU Restaurant,Modern Australian,2,0,19,21,90,10,0
306,Vapiano Bourke Street Mall,Italian,15,1,7,23,30,65,4
307,The Carlton Club,Bar,2,3,11,16,69,12,19
308,KFC Bourke Street Melbourne,Fast Food,9,4,5,18,28,50,22
309,Tim Ho Wan,Chinese,4,3,17,24,71,17,12
310,China Chilli Melbourne Chinatown,Chinese,8,0,18,26,69,31,0
311,Mister Munro,Modern Australian,5,2,20,27,74,19,7
312,Izakaya Den,Japanese,5,0,21,26,81,19,0
313,Taco Bill - Russell St,Mexican,2,0,18,20,90,10,0
314,Pascale Bar & Grill,Bar,6,4,15,25,60,24,16
315,Simpsons Burgers,Burgers,4,0,20,24,83,17,0
316,Sezar Restaurant,Armenian,3,0,20,23,87,13,0
317,Wagaya Melbourne,Japanese,15,3,7,25,28,60,12
318,Harry's Restaurant & Bar,Modern Australian,6,1,13,20,65,30,5
319,Rare Steakhouse Uptown,Steakhouse,0,1,21,22,95,0,5
320,Mamasita,Mexican,7,2,13,22,59,32,9
321,No35,Modern Australian,0,0,25,25,100,0,0
322,Bar Lourinhã,Mediterranean,2,1,19,22,86,9,5
323,Little Collins St Kitchen,Buffet,0,1,21,22,95,0,5
324,Uncle Collins Street,Vietnamese,0,2,18,20,90,0,10
325,Biryani House,Indian,5,3,11,19,58,26,16
326,Kaefei,Café,4,0,18,22,82,18,0
327,??? ZHAN BEERS,Korean,7,0,11,18,61,39,0
328,Paik's Noodle CBD,Korean,3,0,22,25,88,12,0
329,Pokéd,Salads,6,1,9,16,56,38,6
330,Mapo Grill,Korean,5,2,18,25,72,20,8
331,Real Kebab Melbourne,Kebabs,3,1,18,22,82,14,5
332,Tao's Asian BBQ Kitchen,Chinese,7,3,14,24,58,29,12
333,The Mint,Bar & Grill,1,1,11,13,85,8,8
334,Paik's BBQ,Korean,1,3,19,23,83,4,13
335,Korean BBQ & Bar - Yuk Gam,Korean BBQ,2,0,24,26,92,8,0
336,Gukbab,Korean,4,1,15,20,75,20,5
337,PIZZA MONSTER,Pizza,2,0,19,21,90,10,0
338,Nana Izakaya,Japanese,1,1,23,25,92,4,4
339,Seven Star Pocha,Korean,0,2,19,21,90,0,10
340,Nico's Sandwich Deli,Sandwich,3,1,18,22,82,14,5
341,Cafe Court,Café,2,0,19,21,90,10,0
342,Red Cliff Authentic Chinese Restaurant,Chinese,4,2,19,25,76,16,8
343,WATER FLAME,Chinese,2,2,16,20,80,10,10
344,Claypots Barbarossa,Seafood,3,0,15,18,83,17,0
345,Kenny's Bakery Cafe,Café,7,2,17,26,65,27,8
346,Mook Ji Bar,Korean,1,0,20,21,95,5,0
347,The Wanderer Thai Kitchen and Bar,Thai,4,1,22,27,81,15,4
348,Mamak Melbourne,Malaysian,4,1,17,22,77,18,5
349,Dolan Uyghur Cuisine,Uyghur,2,1,18,21,86,10,5
350,Golden Monkey,Bar,1,0,14,15,93,7,0
351,Rice Workshop,Japanese,9,2,9,20,45,45,10
352,Shanghai Taste,Chinese,7,2,13,22,59,32,9
353,Gyoza Gyoza,Japanese,2,0,25,27,93,7,0
354,Cookie,Thai,4,1,20,25,80,16,4
355,The Toff,Bar,6,0,13,19,68,32,0
356,Unabara Lobster & Oyster Bar - Japanese Restaurant Melbourne,Seafood,5,3,14,22,64,23,14
357,I Love Pho Express,Vietnamese,5,3,14,22,64,23,14
358,Tetsujin,Japanese,7,4,10,21,48,33,19
359,EARL Canteen - Emporium,Café,9,1,14,24,58,38,4
360,Pho Bo Ga Mekong Vietnam,Vietnamese,6,1,14,21,67,29,5
361,Calia,Asian Fusion,7,0,15,22,68,32,0
362,Dumplings Plus,Chinese,4,0,15,19,79,21,0
363,Camy Shanghai Dumpling House,Chinese,6,1,17,24,71,25,4
364,VB Rolls,Vietnamese,4,2,21,27,78,15,7
365,Gong De Lin,Vegetarian,5,1,15,21,71,24,5
366,The Crane Restaurant,Asian Fusion,7,2,9,18,50,39,11
367,Dessert Story,Desserts,3,0,18,21,86,14,0
368,Mr Ramen San,Japanese,1,2,18,21,86,5,10
369,Ginza Teppanyaki,Japanese,6,0,17,23,74,26,0
370,Shou Sumiyaki,Japanese,5,0,18,23,78,22,0
371,Seafood Street,Seafood,11,3,8,22,36,50,14
372,Flower Drum Restaurant Melbourne,Chinese,5,1,16,22,73,23,5
373,HuTong,Chinese,8,1,12,21,57,38,5
374,Hofbräuhaus Melbourne,German,2,2,19,23,83,9,9
375,Shoya Japanese Restaurant,Japanese,1,2,16,19,84,5,11
376,Hakata Gensuke Tonkotsu Ramen,Japanese,3,2,16,21,76,14,10
377,Florentino,Italian,3,1,18,22,82,14,5
378,The Elephant & Wheelbarrow,British,7,2,12,21,57,33,10
379,Nando's Bourke St,Fast Food,4,2,11,17,65,24,12
380,Magic Mountain Saloon,Asian Fusion,2,1,20,23,87,9,4
381,Fancy Hank's Barbecue Restaurant,American,2,2,14,18,78,11,11
382,Me Dee Thai Restaurant,Thai,4,1,20,25,80,16,4
383,San Telmo,Argentinian,0,0,22,22,100,0,0
384,Bottega Restaurant,Italian,3,1,20,24,83,12,4
385,Spaghetti Tree,Italian,1,0,19,20,95,5,0
386,Pellegrini's Espresso Bar,Café,1,1,23,25,92,4,4
387,Pizza Pizza Pizza,Pizza,3,2,16,21,76,14,10
388,Bar Carlo,Bar,0,1,18,19,95,0,5
389,Sempre Pizza & Calzone,Italian,0,1,21,22,95,0,5
390,Lupino,Italian,2,1,13,16,81,12,6
391,Tsuru Japanese Restaurant,Japanese,3,1,18,22,82,14,5
392,Hansang,Korean,4,3,13,20,65,20,15
393,Jazz Corner Café,Café,8,1,17,26,65,31,4
394,Bird's Basement,Bar,5,1,20,26,77,19,4
395,Rice Too Asian Cuisine,Chinese,1,0,16,17,94,6,0
396,HWAJOO,Korean,7,1,15,23,65,30,4
397,Lyns Kitchen,Vietnamese,2,1,19,22,86,9,5
398,Operator25,Café,1,5,16,22,73,5,23
399,Izakaya Minami,Japanese,1,1,22,24,92,4,4
400,Little Chef Chinese Restaurant,Chinese,8,4,13,25,52,32,16
401,Brick Lane Melbourne,Café,2,1,22,25,88,8,4
402,Krimper Cafe,Café,2,0,20,22,91,9,0
403,Pretty Boy Italian Steakhouse,Italian,6,0,16,22,73,27,0
404,Scoopy,Desserts,1,2,17,20,85,5,10
405,Golden Mug Cafe,Café,3,0,23,26,88,12,0
406,Dao Noodle ??,Chinese,1,0,20,21,95,5,0
407,CJ Lunch Bar,Korean,3,2,20,25,80,12,8
408,White Mojo,Café,8,1,16,25,64,32,4
409,Hanshin Pocha,Korean,1,1,19,21,90,5,5
410,Ten Square Cafe,Café,5,1,17,23,74,22,4
411,Da Tie Niu,Chinese,11,4,13,28,46,39,14
412,upstairs360,Asian Fusion,8,0,17,25,68,32,0
413,G2 Korean BBQ,Korean BBQ,1,0,23,24,96,4,0
414,Dong Ting-Little Fish & Rice Town,Chinese,12,1,14,27,52,44,4
415,Chilli Everest,Nepalese,5,1,7,13,54,38,8
416,Domino's Pizza Lonsdale St,Pizza,10,3,5,18,28,56,17
417,Tsindos,Greek,3,1,16,20,80,15,5
418,Stalactites Restaurant,Greek,2,1,15,18,83,11,6
419,China Bar Russell Street,Chinese,12,2,11,25,44,48,8
420,Crystal Jade Restaurant,Chinese,10,3,10,23,43,43,13
421,Seoul House Restaurant,Korean,6,3,7,16,44,38,19
422,Boilermaker House,Bar,1,0,16,17,94,6,0
423,At ease - easy Thai,Thai,1,1,20,22,91,5,5
424,Ants Bistro,Chinese,20,1,4,25,16,80,4
425,Sichuan House,Chinese,6,0,13,19,68,32,0
426,Lucky Thursdays,Bar,16,2,3,21,14,76,10
427,Seamstress Restaurant and Bar,Asian Fusion,4,0,19,23,83,17,0
428,Shanghai Village,Chinese,8,2,9,19,47,42,11
429,Gyoza Gyoza,Japanese,2,3,21,26,81,8,12
430,Gingerboy,Asian Fusion,0,0,26,26,100,0,0
431,Locanda Restaurant & Public Bar,Italian,6,1,15,22,68,27,5
432,Punch Lane Wine Bar & Restaurant,Bar,4,0,23,27,85,15,0
433,Longrain Melbourne,Thai,5,0,13,18,72,28,0
434,The European,European,4,1,14,19,74,21,5
435,Red Pepper,Indian,4,2,17,23,74,17,9
436,The Melbourne Supper Club,Bar,3,0,12,15,80,20,0
437,The Waiters Restaurant,Italian,1,3,15,19,79,5,16
438,Butchers Diner,American,4,2,17,23,74,17,9
439,Loop Roof & Loop Top,Bar,3,0,12,15,80,20,0
440,HQ's on William Restaurant & Bar,Modern Australian,2,1,21,24,88,8,4
441,Tokyo 7 Japanese Restaurant,Japanese,7,3,15,25,60,28,12
442,GJ's Grill,Filipino,7,3,11,21,52,33,14
443,Diner on Franklin,Café,3,0,20,23,87,13,0
444,Buza Chicken,Korean,5,1,12,18,67,28,6
445,ABC Chicken,Korean,10,2,12,24,50,42,8
446,Patsy's Melbourne,Vegetarian,1,0,25,26,96,4,0
447,Hua Lu Peking Duck,Chinese,1,1,22,24,92,4,4
448,Yum Sing House Restaurant & Karaoke Bar,Chinese,1,1,23,25,92,4,4
449,David's Hotpot,Hot Pot,6,1,13,20,65,30,5
450,Rainbow Toastie,Burgers,6,0,17,23,74,26,0
451,Bento King,Japanese,5,6,16,27,59,19,22
452,Barkada Pinoy,Filipino,3,2,16,21,76,14,10
453,Sushi Sushi,Sushi,8,3,10,21,48,38,14
454,Little India,Indian,12,1,7,20,35,60,5
455,Little Asia Melbourne Central,Asian,20,1,6,27,22,74,4
456,Oporto,Fast Food,4,1,22,27,81,15,4
457,KFC Melbourne Central Food Court,Fast Food,12,3,7,22,32,55,14
458,O-Bento,Japanese,17,2,5,24,21,71,8
459,Roll'd Melbourne Central,Vietnamese,19,0,8,27,30,70,0
460,Melbourne Central Lion,Bar,7,2,12,21,57,33,10
461,Gyoza Gyoza,Japanese,1,2,26,29,90,3,7
462,Soul Origin Melbourne Central Food Court LG,Salads,12,2,10,24,42,50,8
463,Mad Mex Fresh Mexican - Melbourne Central,Mexican,8,0,13,21,62,38,0
464,Hot Star,Taiwanese,11,3,10,24,42,46,12
465,TGI Fridays Melbourne Central,American,4,1,9,14,64,29,7
466,Mr Tulk Cafe,Café,7,3,14,24,58,29,12
467,Father's Office Speakeasy Bar and Restaurant,Bar,3,1,16,20,80,15,5
468,Grill'd QV,Burgers,5,1,15,21,71,24,5
469,PappaRich QV,Malaysian,13,2,11,26,42,50,8
470,Hanaichi,Japanese,0,1,16,17,94,0,6
471,Schnitz QV,Fast Food,16,5,4,25,16,64,20
472,Sushi Hub QV,Sushi,7,4,12,23,52,30,17
473,Dainty Sichuan Hot Pot - CBD,Hot Pot,0,2,26,28,93,0,7
474,OhGam Korean BBQ Buffet,Korean BBQ,8,1,11,20,55,40,5
475,SPQR Pizzeria,Italian,3,0,19,22,86,14,0
476,RuYi Modern Chinese,Chinese,2,1,24,27,89,7,4
477,Bamboo House - Northern Chinese Fine Dining Cuisine in Melbourne CBD (Chinatown),Chinese,1,1,23,25,92,4,4
478,Hochi Mama,Asian Fusion,0,1,20,21,95,0,5
479,Federici Bistro,Italian,4,0,19,23,83,17,0
480,Amphlett House,Café,1,0,26,27,96,4,0
481,Phancy Cafe & Catering,Café,1,0,19,20,95,5,0
482,The Happy Mexican Rooftop,Mexican,3,0,23,26,88,12,0
483,Hot Star Large Fried Chicken,Taiwanese,11,4,8,23,35,48,17
484,Mansae Korean BBQ - CBD,Korean BBQ,4,3,16,23,70,17,13
485,Jojo Little Kitchen,Malaysian,6,0,17,23,74,26,0
486,Cupanda Kitchen,Chinese,16,0,10,26,38,62,0
487,Morpha,Café,2,0,21,23,91,9,0
488,Ichigo,Japanese,4,1,18,23,78,17,4
489,NeNe Chicken,Korean,9,2,5,16,31,56,12
490,B'Churrasco Brazilian BBQ Restaurant Melbourne,Brazilian ,7,1,13,21,62,33,5
491,Hungry Jack's Burgers La Trobe,Fast Food,6,0,3,9,33,67,0
492,Master Lanzhou Noodle Bar - CBD,Chinese,1,1,18,20,90,5,5
493,No 1. Spicy Pot,Chinese,3,0,20,23,87,13,0
494,Darac,Korean,1,0,17,18,94,6,0
495,KFC 401 Swanston Street,Fast Food,6,3,8,17,47,35,18
496,The Pancake Parlour Melbourne Central,Café,0,0,24,24,100,0,0
497,The Moat,Italian,1,1,24,26,92,4,4
498,Menya Ramen,Japanese,12,0,13,25,52,48,0
499,Pearson & Murphy's Cafe,Café,2,2,13,17,76,12,12
500,Dainty Sichuan Noodles,Chinese,13,1,11,25,44,52,4
501,Jojo Little Kitchen QV,Malaysian,5,1,14,20,70,25,5
502,Ling Nan Chinese Restaurant,Chinese,5,1,10,16,62,31,6
503,Nelayan Restaurant,Indonesian,5,3,18,26,69,19,12
504,Shujinko,Japanese,2,3,17,22,77,9,14
505,New Kum Den,Chinese,4,3,19,26,73,15,12
506,Bombabar,Spanish,2,0,23,25,92,8,0
507,Curry Bowl,Sri Lankan,5,0,16,21,76,24,0
508,Encore Restaurant & Bar,Modern Australian,2,0,20,22,91,9,0
509,The Coopers Inn,Bar,2,0,14,16,88,12,0
510,Yamato Japanese Restaurant,Japanese,8,2,14,24,58,33,8
511,Secret Kitchen Chinatown,Chinese,4,1,14,19,74,21,5
512,Shark Fin Inn,Chinese,3,1,15,19,79,16,5
513,Bodega Underground,Mexican,6,0,20,26,77,23,0
514,Daughter In Law,Indian,2,2,21,25,84,8,8
515,Sunda Dining,Asian,2,0,24,26,92,8,0
516,So Thai,Thai,6,3,13,22,59,27,14
517,atiyah streetfood Queen Victoria Market,Middle Eastern,2,1,19,22,86,9,5
518,YOI Indonesian Fusion,Asian Fusion,1,0,20,21,95,5,0
519,Pelicana Chicken Melbourne,Korean,3,0,27,30,90,10,0
520,McDonald's,Fast Food,11,2,3,16,19,69,12
521,Pondok Rempah Halal Indonesian Restaurant,Indonesian,1,0,26,27,96,4,0
522,Jasper Kitchen,Café,5,3,13,21,62,24,14
523,Sarawak Kitchen,Malaysian,6,1,13,20,65,30,5
524,Subway,Fast Food,13,4,6,23,26,57,17
525,852 Hong Kong Cafe,Café,3,2,16,21,76,14,10
526,Rose Garden BBQ,Malaysian,14,0,11,25,44,56,0
527,Malaysian Laksa House,Malaysian,6,2,19,27,70,22,7
528,Menya Ramen,Japanese,11,3,13,27,48,41,11
529,Dragon Hot Pot Elizabeth,Hot Pot,8,2,12,22,55,36,9
530,Parco Ramen Yatai,Japanese,8,4,12,24,50,33,17
531,Biang! Biang! ,Chinese,5,2,11,18,61,28,11
532,Captain Melville,Bar,4,0,20,24,83,17,0
533,Zhang Liang HotPot (Elizabeth St),Hot Pot,4,0,5,9,56,44,0
534,Surasang Melbourne ,Korean,6,1,13,20,65,30,5
535,Avocado Moment Cafe,Café,1,0,23,24,96,4,0
536,Musou Sichuan Food,Chinese,8,5,16,29,55,28,17
537,Da Long Yi Hot Pot Melbourne,Hot Pot,10,0,9,19,47,53,0
538,Kicks,Bar,6,0,12,18,67,33,0
539,ChangGo Korean BBQ,Korean BBQ,0,2,25,27,93,0,7
540,Joomak,Korean,5,2,16,23,70,22,9
541,Grill'd Melbourne Central,Burgers,5,0,19,24,79,21,0
542,Dear Barbecue Buffet,Buffet,5,0,17,22,77,23,0
543,Vegie Tribe,Vegetarian,2,0,19,21,90,10,0
544,Boss D,Chinese,4,0,18,22,82,18,0
545,OMI Melbourne - Top-notch Japanese Restaurant In Melbourne Central,Japanese,0,1,27,28,96,0,4
546,Yamato@russell,Japanese,6,1,12,19,63,32,5
547,Pachanga,Bar,3,2,6,11,55,27,18
548,Delicious Chao,Chinese,0,3,25,28,89,0,11
549,Big Brother Fish Hot Pot,Chinese,4,4,18,26,69,15,15
550,Grandma's Dumpling ,Chinese,3,2,18,23,78,13,9
551,Sakura Kaiten Sushi,Japanese,8,0,15,23,65,35,0
552,Operator Diner,American,3,0,17,20,85,15,0
553,HongDae Korean Restaurant & Bar,Korean,1,0,19,20,95,5,0
554,KKO-KKO,Korean,1,2,19,22,86,5,9
555,ThaiLicious Restaurant,Thai,2,0,22,24,92,8,0
556,Asian BBQ House,Chinese,10,2,14,26,54,38,8
557,Famil-Lee,Korean,2,2,20,24,83,8,8
558,Pepe's Italian & Liquor,Italian,1,3,21,25,84,4,12
559,Han Guuk Guan,Korean,3,1,13,17,76,18,6
560,Mellow Beans,Café,1,1,21,23,91,4,4
561,Gozleme Turkish Cafe,Turkish,5,1,20,26,77,19,4
562,JUSIK,Korean,1,1,18,20,90,5,5
563,Hello José,Mexican,5,0,13,18,72,28,0
564,Alex Canteen,Vietnamese,4,1,20,25,80,16,4
565,The Mussel Pot,Seafood,3,2,23,28,82,11,7
566,Bratwurst Shop & Co,German,3,0,17,20,85,15,0
567,Corner Chicken Shop,Modern Australian,4,1,22,27,81,15,4
568,Sushi Hub 475 Elizabeth Street,Japanese,6,4,11,21,52,29,19
569,Borek & Gozleme-Turkish Cuisine,Turkish,7,1,14,22,64,32,5
570,My Dumpling Meal,Chinese,6,2,12,20,60,30,10
571,Chef David ,Asian Fusion,0,0,27,27,100,0,0
572,David's Master Pot (Elizabeth St - Melbourne CBD) ,Hot Pot,7,1,14,22,64,32,5
573,No.1 Delicious,Chinese,9,4,11,24,46,38,17
574,Kaki Lima Stewart,Indonesian,11,5,6,22,27,50,23
575,No.1 Delicious BBQ,Hot Pot,5,3,19,27,70,19,11
576,Nisa's Thai Street Food,Thai,1,2,21,24,88,4,8
577,LAURUS | Chinese Restaurant,Chinese,0,0,24,24,100,0,0
578,Soul Soul Cafe,Café,6,0,19,25,76,24,0
579,Chinger Biang Biang Noodle,Chinese,11,2,7,20,35,55,10
580,Panda Hot Pot Carlton ,Hot Pot,3,1,22,26,85,12,4
581,The Best Guilin Rice Noodles,Chinese,6,1,12,19,63,32,5
582,THE CURTIN,Bar,1,0,18,19,95,5,0
583,Hi Chong Qing (Hi CQ),Chinese,1,0,21,22,95,5,0
584,Sonnys Fried Chicken & Burgers,Burgers,6,1,16,23,70,26,4
585,Pho Victoria,Vietnamese,5,2,19,26,73,19,8
586,Matzip Korean BBQ Restaurant,Korean BBQ,2,1,22,25,88,8,4
587,Little Africa Restaurant,Ethiopian,0,1,20,21,95,0,5
588,Chickilia,Korean,2,0,22,24,92,8,0
589,Kebab Connection,Turkish,0,1,22,23,96,0,4
590,Nahm Tao Thai Kitchen,Thai,2,0,15,17,88,12,0
591,BASIC BUNS,Burgers,5,2,16,23,70,22,9
592,Hallah,Korean BBQ,4,2,18,24,75,17,8
593,Yeonga Korean BBQ Restaurant,Korean BBQ,2,0,19,21,90,10,0
594,Curry Corner - Indian Grocery Store in Melbourne,Indian,2,1,15,18,83,11,6
595,Toodouri,Korean BBQ,2,1,15,18,83,11,6
596,The Galbi BBQ,Korean BBQ,0,0,25,25,100,0,0
597,Donwoori Korean Restaurant,Korean ,2,0,15,17,88,12,0
598,El Rincon,Bar,3,1,18,22,82,14,5
599,Canton Malay,Malaysian,8,0,17,25,68,32,0
600,Cafe Victoria,Café,3,0,19,22,86,14,0
601,"3 Brothersss Indian Restaurant (Elizabeth Street, QVM)",Indian,0,0,18,18,100,0,0
602,Kenangan,Indonesian,0,0,21,21,100,0,0
603,Lost in Yunnan Elizabeth ,Chinese,9,2,9,20,45,45,10
604,Hwadam BBQ,Korean BBQ,1,0,21,22,95,5,0
605,Jincheng Lanzhou Beef Noodle Soup ,Chinese,10,1,11,22,50,45,5
606,Manja,Café,2,0,22,24,92,8,0
607,Boogie House Hotpot,Hot Pot,7,3,10,20,50,35,15
608,The Budapest Cafe,Café,7,2,11,20,55,35,10
609,Golden Continent BBQ Grill,Chinese,6,0,6,12,50,50,0
610,Epocha Restaurant | Hope Food & Wine,European,1,0,25,26,96,4,0
611,Sparrow's Philly Cheesesteaks,American,5,1,13,19,68,26,5
612,Rocco’s Bologna Discoteca,Italian,2,0,19,21,90,10,0
613,Maria's Trattoria,Italian,0,2,19,21,90,0,10
614,Path Melbourne,Café,2,1,20,23,87,9,4
615,Kathmandu Banquet,Nepalese,2,0,23,25,92,8,0
616,Eat All Korean BBQ Buffet,Korean BBQ,6,4,14,24,58,25,17
617,Bobbie Peels,Bar,0,2,21,23,91,0,9
618,Classic Curry Indian Restaurant Melbourne,Indian,1,0,21,22,95,5,0
619,BBQ Brothers 10,Korean BBQ,2,1,21,24,88,8,4
620,I Wrap Cafe,Vietnamese,4,2,22,28,79,14,7
621,Dancing Flame Charcoal Grill ,Chinese,4,0,21,25,84,16,0
622,Osha Thai Carlton,Thai,1,1,20,22,91,5,5
623,Torissong,Japanese,2,2,17,21,81,10,10
624,FATTIE PRINCE,Middle Eastern,2,0,21,23,91,9,0
625,The Lincoln,Bar,2,0,14,16,88,12,0
626,Carlton Curry House - Traditional Indian Restaurant,Indian,6,1,13,20,65,30,5
627,ILoveIstanbul,Turkish,2,0,20,22,91,9,0
628,Toto's Pizza House,Italian,1,2,12,15,80,7,13
629,Mercadante Woodfired Pizzeria,Italian,3,1,21,25,84,12,4
630,Lambs on Lygon St,Greek,9,3,13,25,52,36,12
631,Ying Thai 2,Thai,6,2,14,22,64,27,9
632,Saigon Pho,Vietnamese,4,1,19,24,79,17,4
633,Lygon Charcoal Grill and Steakhouse,Steakhouse,3,3,17,23,74,13,13
634,Thai City Restaurant,Thai,0,1,19,20,95,0,5
635,D’Penyetz & D’Cendol Carlton (HALAL),Indonesian,6,0,15,21,71,29,0
636,Martabak Pecenongan 78 @ Lygon Street,Café,5,1,17,23,74,22,4
637,Dong Phuong Vietnamese Cuisine,Vietnamese,13,1,13,27,48,48,4
638,Marion Wine Bar,Bar,4,0,18,22,82,18,0
639,Arabesque Restaurant & Lounge,Middle Eastern,6,2,15,23,65,26,9
640,The Last Jar,Bar,2,0,16,18,89,11,0
641,Seven Seeds Coffee Roasters,Café,4,0,16,20,80,20,0
642,Duke Pizza,Italian,4,3,17,24,71,17,12
643,MOFO Burgers,Burgers,4,0,16,20,80,20,0
644,Leonie Upstairs,Japanese,2,0,17,19,89,11,0
645,Hareruya Pantry,Desserts,0,1,20,21,95,0,5
646,Universal Restaurant,Italian,1,1,14,16,88,6,6
647,Vodka Temple,Bar,5,0,11,16,69,31,0
648,Kazuki's Restaurant,Japanese,3,0,23,26,88,12,0
649,Mandina kitchen,Yemen,10,0,11,21,52,48,0
650,La Cabra Mexican,Mexican,5,1,15,21,71,24,5
651,Il Gambero,Italian,4,1,19,24,79,17,4
652,Da Guido La Pasta,Italian,1,0,22,23,96,4,0
